00000000000000000000
00000000000000000000
00000000000000000000
00000000000000000000
00000000000000000000
00090909090909000900
00909090909090909090
00000000000000000000
10000000000000000000
00000000000000000000

00000000000000000000
00000000000000000000
02000002000000000000
00000000000000000000
00000000000000000000
00000000000000000000
00009000000000000000
99990900000000000000
00000100000000000000
00000000000000000000

00000000000000000000
00000000200000000000
02000000000000000000
00009999000000000000
00090000000000000000
00000000000000000000
00000000000000000000
00000000000000000000
10000100000000000000
00000000000000000000

00000000000000000000
00000000000000000000
00000000000000000000
00099090000000000000
00099090000000000000
99900900990000000000
00000000000000000000
00003003000000000000
10000100100000000000
00000000000000000000

00002000002000000000
00000000000000000000
00200002000000000000
00000000000000000000
00000000090099999900
00009909900000000000
00000000000000000000
00100000000000000000
10001000100000000000
00000000000000000000

00000000000000000000
00000000000000000000
00000000000000000000
90000000990000000000
00999990000000000000
00000000000000000000
70000000070000000000
00000000000000000000
00100010000000000000
00000000000000000000

00000000000000000000
00000000000000000000
00000000000000000000
00999999999900000000
00099999999990000000
00000000000000000000
00000054500009099990
00010000000000100000
00000000000000000000

00000000000000000000
00000000000000000000
00000000000000000000
00000900990000000000
00009099000090009900
90990000000009990090
00000000300000000000
00000000000001000000
00100000000000000000
00000000000000000000

00000000000000000000
00000000000000000000
00000000000000000000
00000000000000000000
90000090900000000000
00999900090000000000
00000000000000000000
03000003500000000000
01000000000000100000
00000000000000000000