0000000000
0000000000
0200000200
0000000000
0000000000
0000000000
1000010000
0000000000

0000000020
0000000000
0200000000
0000000000
0000000000
0000000000
1000010000
0000000000

0000000000
0000000000
0000000000
0000000000
0010300300
0000000000
1000010010
0000000000

0020000200
0000000000
0000000000
0000000000
0000000000
0010000000
1000100010
0000000000

0000000000
0000000000
0000000000
0000000000
0000000000
7000000007
0010001000
0000000000

0000000000
0000000000
0000000000
0000000000
0000000000
0000005450
0000100001
0000000000

0000000000
0000000000
0000000000
0000000000
0000000030
0000000010
0000100000
0000000000

0000000000
0000000000
0000000000
0000000000
0000000000
0300000350
1000001000
0000000000