00000000000000000000
00000000000000000000
00000000000000000000
00000000000000000000
00000000000000000000
00000000000000000000
00000000000000000000
00000000000000000000
00000000000000000000
00000000000000000000
00000000000000000000
00000000000000000000
00000000000000000000
01000000000000000100
00000000000000000000

00000000000000000000
00000000000000000000
00000000000000000000
00000000000000000000
00000000000000000000
00020000200000200000
00000000000000000000
00000000000000000000
00000000000000000000
00000000000000000000
00000990000990099990
00000000000000000000
00000000000000000000
01000000000000000100
00000000000000000000

00000000000000000000
00000000000000000000
00000000000000000000
00000000000000000000
00000000000000000000
00000000000000000000
00000000000000000000
00000000000000000000
00090000090000000000
00909000909090009090
00000909000009090009
00030000003000000300
00000000000000000000
01000000000000000100
00000000000000000000

00000000000000000000
00000000000000000000
00000000000000000000
00000000000000000000
00000000000000000000
00000000000000000000
00000000000000000000
00000000000000000000
00099000099000099900
00900090900900900009
00004000004000000400
00000000000000000000
00000000000000000000
01000000000000000100
00000000000000000000

00000000000000000000
00000000000000000000
00000000000000000000
00000000000000000000
00000000000000000000
00000000000000000000
00000000000000000000
00000000000000000000
00090000090000000000
00909000909090009090
00000909000009090009
00050000000500000050
00000000000000000000
01000000000000000100
00000000000000000000

00000000000000000000
00000000000000000000
00000000000000000000
00000000000000000000
00000000000000000000
00000000000000000000
00000000000000000000
00090000090000000000
00909000909090009090
00000909000009090009
00600000006000000600
00000000000000000000
00000000000000000000
01000000000000000100
00000000000000000000

00000000000000000000
00000000000000000000
00000000000000000000
00000000000000000000
00000000000000000000
00000000000000000000
00000000000000000000
00000000000000000000
00090000090000000000
00909000909090009090
00000909000009090009
00007000000000700000
00000000000000000000
01000000000000000100
00000000000000000000

00000000000000000000
00000000000000000000
00000000000000000000
00000000000000000000
00000000000000000000
00000000000000000000
00000000000000000000
00000000000000000000
00090000090000000000
00909000909090009090
00000909000009090009
00000000000000000000
00000000000000000000
01000000000000000100
00000000000000000000

00000000000000000000
00000000000000000000
00000000000000000000
00000000000000000000
00000000000000000000
00000000000000000000
00000000000000000000
00000000000000000000
00090000090000000000
00909000909090009090
00000909000009090009
00000000000000000000
00000000000000000000
01000000000000000100
00000000000000000000

00000000000000000000
00000000000000000000
00000000000000000000
00000000000000000000
00000000000000000000
00000000000000000000
00000000000000000000
00000000000000000000
00090000090000000000
00909000909090009090
00000909000009090009
00000000000000000000
00000000000000000000
01000000000000000100
00000000000000000000